NO ./textures/map3/wall_1.xpm
WE ./textures/map3/wall_2.xpm
SO ./textures/map3/wall_3.xpm
EA ./textures/map3/wall_4.xpm
DO ./textures/door.xpm

C 44,56,48
F 0,0,0

        1111111111111111111111111
        1000000000110000000000001
        1011000001110000000000001
        1001000000000000000000001
111111111011000001110000000000001
100000000020000001110111121111111
11110111111111011100000010001    
11110111111111011101010010001    
11000000110101011100000010001    
10000000000000002000000010001    
10000000000000001101010020001    
1100N00111010101111101111000111  
11110111 1110101 101111010001    
11111111111111111111111111111    