NO ./textures/map2/wall_1.xpm
WE ./textures/map2/wall_2.xpm
SO ./textures/map2/wall_3.xpm
EA ./textures/map2/wall_4.xpm
DO ./textures/door.xpm

C 44,56,48
F 0,0,0

1111111111111111111
1000000010000000001
1000000020000000001
1001100010000000001
1001100011111211111
100110001S010010001
1001100010010010001
1121112110010010001
1001000012110011211
1001000010000000001
1001000010000000001
1002000010000000001
1001000010000000001
1111111111111111111